{
    "map": {
        "width": 10,
        "height": 10,
        "tilewidth": 32,
        "tileheight": 32,
        "tilesets": [
            {
                "source": "assets/png/spritesheet.png"
            }
        ],
        "layers": [
            {
                "id": 0,
                "data": [
                    [1, 1, 1, 1, 1, 1, 1, 1, 1, 1],
                    [1, 1, 1, 1, 1, 1, 1, 1, 1, 1],
                    [1, 1, 1, 1, 1, 1, 1, 1, 1, 1],
                    [1, 1, 1, 1, 1, 1, 1, 1, 1, 1],
                    [1, 1, 1, 1, 1, 1, 1, 1, 1, 1],
                    [1, 1, 1, 1, 1, 1, 1, 1, 1, 1],
                    [1, 1, 1, 1, 1, 1, 1, 1, 1, 1],
                    [1, 1, 1, 1, 1, 1, 1, 1, 1, 1],
                    [1, 1, 1, 1, 1, 1, 1, 1, 1, 1],
                    [1, 1, 1, 1, 1, 1, 1, 1, 1, 1]
                ]
            },
            {
                "id": 1,
                "data": [
                    [9, 3, 55, 25, 41, 2, 35, 46, 47, 7],
                    [40, 54, 20, 14, 45, 55, 18, 12, 7, 13],
                    [27, 35, 34, 54, 59, 15, 32, 33, 59, 53],
                    [13, 39, 52, 14, 6, 17, 45, 0, 0, 26],
                    [15, 35, 50, 48, 44, 55, 29, 34, 18, 23],
                    [30, 60, 39, 39, 20, 28, 2, 30, 34, 16],
                    [3, 7, 8, 5, 23, 24, 13, 59, 53, 38],
                    [37, 57, 29, 41, 5, 34, 37, 35, 13, 17],
                    [7, 23, 53, 5, 5, 35, 59, 39, 15, 31],
                    [1, 56, 13, 54, 13, 36, 16, 19, 0, 17]
                ]
            }
        ]
    }
}
