{
    "map": {
      "version": "1.10",
      "width": 30,
      "height": 30,
      "tilewidth": 32,
      "tileheight": 32,
      "nextlayerid": 4,
      "nextobjectid": 1,
      "tilesets": [
        {
          "firstgid": 1,
          "source": "spritesheetTest.tsx"
        }
      ],
      "layers": [
        {
          "id": 1,
          "name": "Livello tile 1",
          "width": 30,
          "height": 30,
          "data": [
            37,37,37,37,37,37,37,24,24,24,24,24,24,24,24,24,24,24,24,24,24,24,24,24,24,24,24,24,24,24,
            37,37,37,37,37,37,37,24,24,24,24,24,24,24,24,24,24,24,24,24,24,24,24,24,24,24,24,24,24,24,
            37,37,37,37,37,37,37,24,24,24,24,24,24,24,24,24,24,24,24,24,24,24,24,24,24,24,24,24,24,24,
            37,37,37,37,37,37,37,24,24,24,24,24,24,24,24,24,24,24,24,24,24,24,24,24,24,24,24,24,24,24,
            37,37,37,37,37,37,37,24,24,24,24,24,24,24,24,24,24,24,24,24,24,24,24,24,24,24,24,24,24,24,
            37,37,37,37,37,37,37,24,24,24,24,24,24,24,24,24,24,24,24,24,24,24,24,24,24,24,24,24,24,24,
            37,37,37,37,37,37,37,24,24,24,24,24,24,24,24,24,24,24,24,24,24,24,24,24,24,24,24,24,24,24,
            37,37,37,37,37,37,37,24,24,24,24,24,24,24,24,24,24,24,24,24,24,24,24,24,24,24,24,24,24,24,
            24,24,24,24,24,24,24,24,24,24,24,24,24,24,24,24,24,24,24,24,24,24,24,24,24,24,24,24,24,24,
            24,24,24,24,24,24,24,24,24,24,24,24,24,24,24,24,24,24,24,24,24,24,24,24,24,24,24,24,24,24,
            24,24,24,24,24,24,24,24,24,24,24,24,24,24,24,24,24,24,24,24,24,24,24,24,24,24,24,24,24,24,
            24,24,24,24,24,24,24,24,24,24,24,24,24,24,24,24,24,24,24,24,24,24,24,24,24,24,24,24,24,24,
            24,24,24,24,24,24,24,24,24,24,24,24,24,24,24,24,24,24,24,24,24,24,24,24,24,24,24,24,24,24
          ]
        }
      ]
    }
  }
  